########
#o#x   #
# @    #
# @@   #
# @@@  #
########
